user,year,frequency,fast_quality,CI,ultra_bullet_blitz_games_year,max_ultra_bullet_blitz_games_year,ultrabullet,bullet,blitz,rapid,total,user_id,rating_level,start_rating_year,end_rating_year,delta_elo_year,active_months_year
Obese_reece,2023,0.2863,0.3445,0.3154,2905,10148,3,635,2267,184,3089,Obese_reece,Intermedio,1596,1665,69,4
Obese_reece,2024,0.3136,0.4327,0.3732,3182,10148,3,1437,1742,25,3207,Obese_reece,Intermedio,1665,1713,48,8
Obese_reece,2025,0.2001,0.4187,0.3094,2031,10148,3,865,1163,49,2080,Obese_reece,Intermedio,1713,1742,29,4
purplechess64,2023,0.9854,0.6017,0.7935,10000,10148,74,9885,41,1,10001,purplechess64,Avanzato,1918,1912,-6,1
purplechess64,2024,0.4786,0.5999,0.5393,4857,10148,0,4856,1,0,4857,purplechess64,Avanzato,1912,1838,-74,2
purplechess64,2025,0.4269,0.6027,0.5148,4332,10148,41,4276,15,0,4332,purplechess64,Intermedio,1838,1730,-108,3
HluliM,2023,0.1665,0.2522,0.2094,1690,10148,0,56,1634,387,2077,HluliM,Intermedio,1657,1667,10,1
HluliM,2025,0.3677,0.4205,0.3941,3731,10148,0,1731,2000,166,3897,HluliM,Intermedio,1667,1570,-97,1
GomezDanielMx,2023,0.4639,0.541,0.5025,4708,10148,0,3797,911,8,4716,GomezDanielMx,Intermedio,1833,1669,-164,5
GomezDanielMx,2024,0.239,0.5902,0.4146,2425,10148,0,2346,79,0,2425,GomezDanielMx,Intermedio,1669,1630,-39,6
GomezDanielMx,2025,0.1934,0.5953,0.3943,1963,10148,0,1932,31,0,1963,GomezDanielMx,Intermedio,1630,1622,-8,3
talitoesterio,2023,0.2517,0.3646,0.3082,2554,10148,0,915,1639,300,2854,talitoesterio,Intermedio,1705,1751,46,4
talitoesterio,2024,0.1814,0.4306,0.306,1841,10148,0,1153,688,245,2086,talitoesterio,Intermedio,1751,1720,-31,3
Narek15,2023,0.1807,0.594,0.3874,1834,10148,0,1829,5,16,1850,Narek15,Beginner,1354,1459,105,5
Narek15,2024,0.4233,0.5969,0.5101,4296,10148,0,4291,5,20,4316,Narek15,Avanzato,1932,1710,-222,7
Narek15,2025,0.3016,0.5989,0.4503,3061,10148,0,3060,1,5,3066,Narek15,Intermedio,1710,1748,38,3
NicolaNigro,2023,0.0252,0.5168,0.271,256,10148,0,185,71,0,256,NicolaNigro,Avanzato,2014,2034,20,2
Eusekevin,2023,0.0168,0.0157,0.0162,170,10148,0,0,170,3088,3258,Eusekevin,Avanzato,1941,1906,-35,1
Eusekevin,2024,0.1021,0.0736,0.0879,1036,10148,0,0,1036,3184,4220,Eusekevin,Avanzato,1906,1877,-29,1
harshilsrome,2024,0.0112,0.5184,0.2648,114,10148,0,83,31,0,114,harshilsrome,Beginner,1100,1087,-13,1
harshilsrome,2025,0.0267,0.4395,0.2331,271,10148,0,126,145,0,271,harshilsrome,Beginner,1087,1153,66,4
Sultai,2023,0.4979,0.4887,0.4933,5053,10148,866,1346,2841,116,5169,Sultai,Intermedio,1548,1699,151,4
Sultai,2024,0.1205,0.4037,0.2621,1223,10148,66,425,732,116,1339,Sultai,Avanzato,1945,1992,47,5
Sultai,2025,0.0403,0.6534,0.3469,409,10148,243,76,90,74,483,Sultai,Avanzato,1992,1985,-7,3
Patoruzu9,2023,0.0007,0.0048,0.0027,7,10148,0,2,5,557,564,Patoruzu9,Intermedio,1743,1747,4,1
horacio-cadu,2023,0.3887,0.1378,0.2633,3945,10148,0,0,3945,4645,8590,horacio-cadu,Avanzato,1962,1947,-15,1
Skippyman,2023,0.4502,0.3033,0.3768,4569,10148,0,51,4518,0,4569,Skippyman,Avanzato,2065,1996,-69,1
Skippyman,2024,0.3909,0.3002,0.3455,3967,10148,0,2,3965,0,3967,Skippyman,Avanzato,1996,1920,-76,1
Skippyman,2025,0.1881,0.3,0.2441,1909,10148,0,0,1909,0,1909,Skippyman,Avanzato,1920,1892,-28,1
chesspinamar,2023,0.3465,0.3165,0.3315,3516,10148,0,227,3289,32,3548,chesspinamar,Intermedio,1653,1638,-15,2
chesspinamar,2024,0.1733,0.3124,0.2428,1759,10148,0,86,1673,13,1772,chesspinamar,Intermedio,1638,1667,29,3
chesspinamar,2025,0.2273,0.3046,0.2659,2307,10148,0,35,2272,0,2307,chesspinamar,Intermedio,1667,1633,-34,2
naron26,2023,0.215,0.3337,0.2744,2182,10148,0,261,1921,14,2196,naron26,Intermedio,1600,1565,-35,1
imaxwell,2024,0.116,0.1807,0.1483,1177,10148,0,0,1177,777,1954,imaxwell,Beginner,1092,1128,36,1
TheSparkCraft,2023,0.1655,0.3153,0.2404,1680,10148,0,689,991,574,2254,TheSparkCraft,Intermedio,1470,1517,47,1
TheSparkCraft,2024,0.3106,0.5698,0.4402,3152,10148,0,2905,247,37,3189,TheSparkCraft,Intermedio,1517,1503,-14,2
TheSparkCraft,2025,0.126,0.5054,0.3157,1279,10148,0,970,309,56,1335,TheSparkCraft,Intermedio,1503,1532,29,1
Maryse-EPL,2023,0.2223,0.2979,0.2601,2256,10148,0,0,2256,16,2272,Maryse-EPL,Beginner,1322,1284,-38,4
Maryse-EPL,2024,0.1426,0.2998,0.2212,1447,10148,0,0,1447,1,1448,Maryse-EPL,Beginner,1284,1257,-27,6
Maryse-EPL,2025,0.1872,0.3,0.2436,1900,10148,0,0,1900,0,1900,Maryse-EPL,Beginner,1257,1223,-34,5
Irian-Jaya,2023,0.1374,0.5998,0.3686,1394,10148,0,1393,1,0,1394,Irian-Jaya,Intermedio,1445,1447,2,2
Irian-Jaya,2024,0.0281,0.5054,0.2668,285,10148,0,212,73,10,295,Irian-Jaya,Intermedio,1447,1472,25,2
Irian-Jaya,2025,0.2845,0.5937,0.4391,2887,10148,0,2832,55,3,2890,Irian-Jaya,Intermedio,1472,1487,15,2
SebaSaez3,2023,0.1779,0.4051,0.2915,1805,10148,0,1025,780,291,2096,SebaSaez3,Beginner,1192,1229,37,1
SebaSaez3,2024,0.2335,0.4525,0.343,2370,10148,0,1262,1108,38,2408,SebaSaez3,Beginner,1229,1150,-79,2
SebaSaez3,2025,0.1156,0.4325,0.274,1173,10148,0,521,652,2,1175,SebaSaez3,Beginner,1150,1120,-30,2
PADILLON,2023,0.1134,0.3,0.2067,1151,10148,0,0,1151,0,1151,PADILLON,Avanzato,2081,2065,-16,1
Thunder2021,2024,0.7868,0.3204,0.5536,7984,10148,0,542,7442,0,7984,Thunder2021,Intermedio,1823,1810,-13,1
Kaspesky98,2023,0.0833,0.5723,0.3278,845,10148,0,767,78,0,845,Kaspesky98,Intermedio,1810,1796,-14,1
gmgattass,2023,0.2081,0.3182,0.2632,2112,10148,0,128,1984,0,2112,gmgattass,Master,2246,2225,-21,3
gmgattass,2024,0.3762,0.3338,0.355,3818,10148,0,449,3369,17,3835,gmgattass,Avanzato,2193,2193,0,2
gmgattass,2025,0.9834,0.2997,0.6416,9980,10148,0,0,9980,10,9990,gmgattass,Avanzato,2187,2178,-9,3
alram1992,2023,0.3534,0.5994,0.4764,3586,10148,0,3585,1,3,3589,alram1992,Intermedio,1528,1532,4,2
alram1992,2024,0.1934,0.5837,0.3886,1963,10148,0,1932,31,39,2002,alram1992,Intermedio,1532,1530,-2,1
alram1992,2025,0.1332,0.585,0.3591,1352,10148,0,1347,5,32,1384,alram1992,Intermedio,1530,1513,-17,1
andrbind,2023,0.4672,0.3,0.3836,4741,10148,0,0,4741,0,4741,andrbind,Intermedio,1852,1836,-16,2
andrbind,2024,0.5461,0.3764,0.4613,5542,10148,0,1412,4130,0,5542,andrbind,Intermedio,1836,1840,4,1
andrbind,2025,0.2642,0.3,0.2821,2681,10148,0,0,2681,0,2681,andrbind,Intermedio,1840,1830,-10,1
cldng,2023,0.2508,0.4862,0.3685,2545,10148,0,1588,957,5,2550,cldng,Avanzato,1985,1934,-51,1
cldng,2024,0.2615,0.5519,0.4067,2654,10148,0,2238,416,5,2659,cldng,Avanzato,1934,1880,-54,5
cldng,2025,0.2029,0.3764,0.2897,2059,10148,0,556,1503,25,2084,cldng,Intermedio,1880,1852,-28,3
Corazonaguara,2024,0.178,0.5806,0.3793,1806,10148,0,1691,115,1,1807,Corazonaguara,Avanzato,1942,1942,0,1
Coquito06,2023,0.2944,0.4851,0.3898,2988,10148,68,2012,908,202,3190,Coquito06,Avanzato,2051,2064,13,3
Coquito06,2024,0.8573,0.3935,0.6254,8700,10148,49,3128,5523,404,9104,Coquito06,Avanzato,2064,2088,24,1
Coquito06,2025,0.5932,0.3895,0.4913,6020,10148,25,2369,3626,487,6507,Coquito06,Avanzato,2088,2093,5,1
moi431,2023,0.0397,0.5993,0.3195,403,10148,0,402,1,0,403,moi431,Beginner,1366,1351,-15,2
Angbatil,2024,0.8885,0.3,0.5942,9016,10148,0,2,9014,2,9018,Angbatil,Master,2284,2268,-16,1
Angbatil,2025,0.5216,0.3,0.4108,5293,10148,0,0,5293,0,5293,Angbatil,Master,2268,2262,-6,2
Teachercoachbatil,2023,0.3906,0.3027,0.3467,3964,10148,0,956,3008,912,4876,Teachercoachbatil,Intermedio,1638,1652,14,1
Teachercoachbatil,2024,0.9693,0.3454,0.6573,9836,10148,0,1753,8083,231,10067,Teachercoachbatil,Intermedio,1652,1605,-47,1
AdamIsmail,2025,0.5756,0.6063,0.591,5841,10148,109,5710,22,0,5841,AdamIsmail,Intermedio,1560,1647,87,1
Dr-Lam98,2023,0.2058,0.3294,0.2676,2088,10148,0,353,1735,135,2223,Dr-Lam98,Intermedio,1671,1651,-20,1
Dr-Lam98,2024,0.1321,0.2793,0.2057,1341,10148,0,20,1321,121,1462,Dr-Lam98,Intermedio,1651,1592,-59,2
AAponte,2025,0.4938,0.577,0.5354,5011,10148,0,4626,385,0,5011,AAponte,Avanzato,2080,2074,-6,1
Aiskandar,2024,0.0995,0.4538,0.2767,1010,10148,0,769,241,166,1176,Aiskandar,Beginner,1343,1407,64,1
chramirezb,2023,0.5858,0.6,0.5929,5945,10148,0,5945,0,0,5945,chramirezb,Master,2229,2189,-40,2
chramirezb,2024,0.5739,0.6,0.587,5824,10148,0,5824,0,0,5824,chramirezb,Avanzato,2189,2120,-69,9
chramirezb,2025,0.3642,0.5998,0.482,3696,10148,0,3696,0,1,3697,chramirezb,Avanzato,2120,2135,15,4
vidipkumarkona,2023,0.0623,0.646,0.3542,632,10148,303,233,96,98,730,vidipkumarkona,Intermedio,1790,1869,79,5
vidipkumarkona,2024,0.1191,0.6378,0.3785,1209,10148,531,607,71,228,1437,vidipkumarkona,Avanzato,2095,2095,0,7
vidipkumarkona,2025,0.098,0.6038,0.3509,994,10148,456,329,209,192,1186,vidipkumarkona,Avanzato,2084,2145,61,7
PetroffMagic,2023,0.0648,0.2561,0.1605,658,10148,0,1,657,114,772,PetroffMagic,Avanzato,2095,2096,1,2
PetroffMagic,2024,0.1629,0.2765,0.2197,1653,10148,0,4,1649,145,1798,PetroffMagic,Avanzato,2096,2058,-38,6
PetroffMagic,2025,0.1303,0.2812,0.2057,1322,10148,0,6,1316,95,1417,PetroffMagic,Avanzato,2058,2025,-33,4
NikolayIvanchikov,2023,0.4196,0.3,0.3598,4258,10148,0,0,4258,0,4258,NikolayIvanchikov,Beginner,1270,1325,55,1
FedirBohatyrchuk1892,2023,0.1977,0.9988,0.5982,2006,10148,2002,1,3,0,2006,FedirBohatyrchuk1892,Avanzato,2136,2142,6,3
FedirBohatyrchuk1892,2024,0.4066,0.7577,0.5821,4126,10148,2474,527,1125,2,4128,FedirBohatyrchuk1892,Avanzato,2142,2235,93,2
rpm198,2023,0.4437,0.3,0.3719,4503,10148,0,0,4503,0,4503,rpm198,Avanzato,2082,2049,-33,7
rpm198,2024,0.4875,0.3,0.3937,4947,10148,0,0,4947,0,4947,rpm198,Avanzato,2049,2096,47,4
rpm198,2025,0.268,0.3037,0.2859,2720,10148,0,34,2686,0,2720,rpm198,Avanzato,2096,2062,-34,1
Cyprianophobic78,2023,0.2089,0.3,0.2545,2120,10148,0,0,2120,0,2120,Cyprianophobic78,Intermedio,1602,1566,-36,1
Cyprianophobic78,2024,0.3402,0.3,0.3201,3452,10148,0,0,3452,0,3452,Cyprianophobic78,Intermedio,1566,1578,12,1
Cyprianophobic78,2025,0.3159,0.3,0.308,3206,10148,0,0,3206,0,3206,Cyprianophobic78,Intermedio,1578,1558,-20,1
Knightmare1313,2024,0.1355,0.322,0.2288,1375,10148,0,102,1273,1,1376,Knightmare1313,Beginner,1344,1258,-86,2
Knightmare1313,2025,0.0938,0.2984,0.1961,952,10148,0,0,952,5,957,Knightmare1313,Beginner,1258,1240,-18,3
kevin6765,2023,0.3789,0.3038,0.3414,3845,10148,0,143,3702,93,3938,kevin6765,Intermedio,1682,1724,42,3
kevin6765,2024,0.4887,0.3144,0.4015,4959,10148,0,383,4576,139,5098,kevin6765,Intermedio,1724,1667,-57,1
dvaldez,2025,0.2355,0.5554,0.3955,2390,10148,0,2035,355,0,2390,dvaldez,Intermedio,1587,1710,123,2
Steiger,2023,0.2918,0.3009,0.2963,2961,10148,0,15,2946,6,2967,Steiger,Intermedio,1846,1902,56,5
Steiger,2024,0.2857,0.2998,0.2927,2899,10148,0,0,2899,2,2901,Steiger,Avanzato,1902,1902,0,4
Steiger,2025,0.1859,0.3,0.243,1887,10148,0,1,1886,1,1888,Steiger,Intermedio,1890,1877,-13,1
RAG0406,2024,0.1499,0.5687,0.3593,1521,10148,0,1368,153,3,1524,RAG0406,Avanzato,2174,2177,3,2
tolga48,2024,0.176,0.2988,0.2374,1786,10148,0,1,1785,8,1794,tolga48,Intermedio,1486,1492,6,1
michaelskie11,2023,0.0229,0.376,0.1994,232,10148,0,60,172,1,233,michaelskie11,Avanzato,2091,2087,-4,4
michaelskie11,2024,0.008,0.5667,0.2873,81,10148,0,72,9,0,81,michaelskie11,Avanzato,2087,2095,8,3
hykaruz,2023,0.0486,0.3,0.1743,493,10148,0,0,493,0,493,hykaruz,Intermedio,1400,1426,26,1
Jomajo,2024,0.2962,0.3033,0.2998,3006,10148,0,33,2973,0,3006,Jomajo,Master,2363,2352,-11,2
Jomajo,2025,0.2437,0.3,0.2718,2473,10148,0,0,2473,0,2473,Jomajo,Master,2352,2347,-5,1
Kerbebos,2024,0.3067,0.3195,0.3131,3112,10148,19,176,2917,17,3129,Kerbebos,Intermedio,1729,1873,144,4
Kerbebos,2025,0.216,0.3094,0.2627,2192,10148,0,71,2121,2,2194,Kerbebos,Avanzato,1923,1923,0,1
Lazarinho99,2023,0.3898,0.3664,0.3781,3956,10148,0,875,3081,0,3956,Lazarinho99,Intermedio,1860,1822,-38,4
Lazarinho99,2024,0.4017,0.4094,0.4055,4076,10148,0,1489,2587,2,4078,Lazarinho99,Intermedio,1822,1803,-19,7
Lazarinho99,2025,0.3258,0.4827,0.4042,3306,10148,4,2004,1298,0,3306,Lazarinho99,Intermedio,1803,1798,-5,6
Ariel_Martinez,2023,0.2001,0.3009,0.2505,2031,10148,0,9,2022,3,2034,Ariel_Martinez,Avanzato,2121,2145,24,6
Ariel_Martinez,2024,0.6646,0.2992,0.4819,6744,10148,0,6,6738,25,6769,Ariel_Martinez,Avanzato,2145,2103,-42,7
Ariel_Martinez,2025,0.5178,0.3001,0.4089,5255,10148,0,1,5254,0,5255,Ariel_Martinez,Avanzato,2103,2138,35,4
Palito2016,2023,0.2024,0.2884,0.2454,2054,10148,0,138,1916,226,2280,Palito2016,Intermedio,1656,1702,46,2
Palito2016,2024,0.0647,0.2573,0.161,657,10148,0,5,652,115,772,Palito2016,Intermedio,1702,1602,-100,3
Palito2016,2025,0.0896,0.2723,0.1809,909,10148,0,6,903,99,1008,Palito2016,Intermedio,1602,1562,-40,3
berlinerbolle,2024,0.0004,0.0004,0.0004,4,10148,0,0,4,3057,3061,berlinerbolle,Beginner,1236,1217,-19,1
Bntary007,2023,0.9844,0.3,0.6422,9990,10148,0,0,9990,1,9991,Bntary007,Intermedio,1811,1824,13,1
Bntary007,2024,0.88,0.2993,0.5896,8930,10148,0,1,8929,22,8952,Bntary007,Intermedio,1824,1813,-11,1
Bntary007,2025,0.4114,0.2972,0.3543,4175,10148,0,0,4175,39,4214,Bntary007,Intermedio,1813,1745,-68,1
faresanta,2023,0.0112,0.1606,0.0859,114,10148,0,0,114,99,213,faresanta,Intermedio,1609,1620,11,1
faresanta,2024,0.0126,0.2176,0.1151,128,10148,0,4,124,54,182,faresanta,Intermedio,1620,1598,-22,1
subkat,2023,0.0367,0.6,0.3183,372,10148,0,372,0,0,372,subkat,Avanzato,2171,2171,0,1
subkat,2024,0.0257,0.6,0.3129,261,10148,0,261,0,0,261,subkat,Avanzato,2171,2144,-27,3
Kabral71,2023,0.6933,0.5917,0.6425,7036,10148,0,6872,164,16,7052,Kabral71,Avanzato,1963,1977,14,4
Kabral71,2024,0.5775,0.5956,0.5866,5860,10148,0,5775,85,0,5860,Kabral71,Avanzato,1977,1988,11,3
Schluckauf,2023,0.8139,0.5964,0.7051,8259,10148,0,8159,100,0,8259,Schluckauf,Avanzato,2079,2083,4,7
Schluckauf,2024,0.858,0.3745,0.6163,8707,10148,0,2163,6544,0,8707,Schluckauf,Avanzato,2083,2023,-60,8
Schluckauf,2025,0.7432,0.3,0.5216,7542,10148,0,4,7538,3,7545,Schluckauf,Avanzato,2023,2035,12,4
AAashraf,2023,0.0112,0.3237,0.1675,114,10148,0,9,105,0,114,AAashraf,Intermedio,1838,1731,-107,2
emp4,2023,0.4162,0.5955,0.5058,4224,10148,0,4166,58,3,4227,emp4,Intermedio,1759,1745,-14,1
Sale_Serbia,2023,0.0426,0.2299,0.1362,432,10148,0,1,431,133,565,Sale_Serbia,Beginner,1221,1196,-25,3
el_perro_orfeo,2023,0.5536,0.4578,0.5057,5618,10148,89,3494,2035,489,6107,el_perro_orfeo,Intermedio,1588,1509,-79,3
el_perro_orfeo,2024,0.5198,0.5161,0.518,5275,10148,2,4293,980,289,5564,el_perro_orfeo,Intermedio,1509,1568,59,1
el_perro_orfeo,2025,0.5519,0.5337,0.5428,5601,10148,0,4616,985,142,5743,el_perro_orfeo,Intermedio,1568,1557,-11,2
CarlosBarreto,2023,0.0001,0.0002,0.0001,1,10148,0,0,1,1698,1699,CarlosBarreto,Intermedio,1710,1690,-20,3
CarlosBarreto,2024,0.0005,0.0022,0.0014,5,10148,0,4,1,1208,1213,CarlosBarreto,Intermedio,1690,1693,3,2
CarlosBarreto,2025,0.007,0.0315,0.0193,71,10148,0,3,68,633,704,CarlosBarreto,Intermedio,1693,1693,0,1
param00,2023,0.0967,0.2991,0.1979,981,10148,0,0,981,3,984,param00,Beginner,1302,1341,39,2
param00,2024,0.1697,0.2998,0.2348,1722,10148,0,0,1722,1,1723,param00,Beginner,1341,1373,32,2
param00,2025,0.0709,0.3,0.1854,719,10148,0,0,719,0,719,param00,Beginner,1373,1387,14,1
FRAM3D_T,2023,0.6451,0.3346,0.4898,6546,10148,0,861,5685,96,6642,FRAM3D_T,Beginner,1271,1451,180,2
FRAM3D_T,2024,0.3574,0.3036,0.3305,3627,10148,0,68,3559,24,3651,FRAM3D_T,Intermedio,1451,1643,192,4
FRAM3D_T,2025,0.1253,0.3244,0.2249,1272,10148,0,111,1161,7,1279,FRAM3D_T,Intermedio,1643,1722,79,4
MatanSon17,2025,0.1806,0.5899,0.3852,1833,10148,0,1773,60,1,1834,MatanSon17,Intermedio,1727,1707,-20,1
Osiel09,2023,0.2583,0.4805,0.3694,2621,10148,17,1678,926,88,2709,Osiel09,Intermedio,1889,1857,-32,1
Osiel09,2024,0.7577,0.5171,0.6374,7689,10148,34,5550,2105,37,7726,Osiel09,Intermedio,1857,1737,-120,4
Tervaskanto,2023,0.0907,0.3,0.1953,920,10148,0,7,913,7,927,Tervaskanto,Avanzato,2072,2021,-51,1
Tervaskanto,2025,0.0706,0.3,0.1853,716,10148,0,0,716,0,716,Tervaskanto,Avanzato,2021,1962,-59,1
Lukiebear,2023,0.1541,0.2996,0.2269,1564,10148,0,0,1564,2,1566,Lukiebear,Intermedio,1461,1434,-27,2
Lukiebear,2024,0.1805,0.3,0.2403,1832,10148,0,0,1832,0,1832,Lukiebear,Intermedio,1434,1503,69,2
Lukiebear,2025,0.1212,0.3,0.2106,1230,10148,0,1,1229,1,1231,Lukiebear,Intermedio,1503,1548,45,1
JohnnyHeizer,2023,0.0003,0.0003,0.0003,3,10148,0,0,3,2993,2996,JohnnyHeizer,Avanzato,2034,2041,7,10
JohnnyHeizer,2024,0.0001,0.0001,0.0001,1,10148,0,0,1,2811,2812,JohnnyHeizer,Avanzato,2041,2062,21,9
pzpz,2023,0.0003,0.0002,0.0002,3,10148,0,0,3,4746,4749,pzpz,Intermedio,1425,1405,-20,6
inter_mezzo,2023,0.0006,0.0034,0.002,6,10148,0,0,6,523,529,inter_mezzo,Intermedio,1716,1749,33,1
leonkiller77,2022,0.0001,0.6,0.3,1,10148,0,1,0,0,1,leonkiller77,Master,2344,2327,-17,6
leonkiller77,2023,0.9122,0.5828,0.7475,9257,10148,0,8735,522,4,9261,leonkiller77,Master,2327,2308,-19,12
leonkiller77,2024,0.5644,0.5575,0.561,5728,10148,0,4917,811,0,5728,leonkiller77,Master,2308,2314,6,11
leonkiller77,2025,0.1983,0.3,0.2491,2012,10148,0,0,2012,0,2012,leonkiller77,Master,2314,2309,-5,7
eduardo0827,2023,0.1032,0.4342,0.2687,1047,10148,0,490,557,15,1062,eduardo0827,Intermedio,1822,1834,12,1
eduardo0827,2024,0.3546,0.3507,0.3526,3598,10148,0,621,2977,11,3609,eduardo0827,Intermedio,1834,1802,-32,2
svenycar22,2023,0.0223,0.3753,0.1988,226,10148,0,58,168,1,227,svenycar22,Intermedio,1609,1632,23,4
svenycar22,2024,0.0431,0.4449,0.244,437,10148,0,211,226,0,437,svenycar22,Intermedio,1632,1680,48,3
svenycar22,2025,0.0657,0.4912,0.2784,667,10148,0,425,242,0,667,svenycar22,Intermedio,1680,1710,30,2
EricLeone,2023,0.4988,0.3949,0.4468,5062,10148,0,1615,3447,11,5073,EricLeone,Avanzato,2078,2056,-22,2
EricLeone,2024,0.9776,0.5726,0.7751,9921,10148,0,9083,838,35,9956,EricLeone,Avanzato,2056,2056,0,3
EricLeone,2025,0.4659,0.3683,0.4171,4728,10148,0,1088,3640,10,4738,EricLeone,Avanzato,2056,2053,-3,2
frankthird,2023,0.0147,0.3,0.1573,149,10148,0,0,149,0,149,frankthird,Avanzato,2181,2171,-10,5
frankthird,2024,0.3352,0.4829,0.4091,3402,10148,0,2074,1328,0,3402,frankthird,Avanzato,2171,2162,-9,3
frankthird,2025,0.3966,0.5394,0.468,4025,10148,0,3212,813,0,4025,frankthird,Avanzato,2162,2169,7,5
galvezmotril,2023,0.0001,0.0375,0.0188,1,10148,0,0,1,7,8,galvezmotril,Intermedio,1760,1753,-7,5
galvezmotril,2024,0.3277,0.2998,0.3138,3326,10148,0,0,3326,2,3328,galvezmotril,Intermedio,1753,1708,-45,2
galvezmotril,2025,0.1716,0.2865,0.229,1741,10148,0,0,1741,82,1823,galvezmotril,Intermedio,1708,1712,4,1
Echigar,2023,0.0692,0.3331,0.2012,702,10148,4,86,612,16,718,Echigar,Intermedio,1552,1533,-19,3
Echigar,2025,0.0954,0.3422,0.2188,968,10148,0,142,826,5,973,Echigar,Intermedio,1533,1532,-1,1
gorditoperro,2023,0.2972,0.3116,0.3044,3016,10148,11,108,2897,16,3032,gorditoperro,Master,2329,2323,-6,7
gorditoperro,2024,0.2223,0.3498,0.2861,2256,10148,0,391,1865,14,2270,gorditoperro,Master,2323,2342,19,5
gorditoperro,2025,0.169,0.3722,0.2706,1715,10148,0,415,1300,2,1717,gorditoperro,Master,2342,2344,2,4
joesal,2024,0.4036,0.2995,0.3516,4096,10148,0,16,4080,23,4119,joesal,Intermedio,1539,1448,-91,1
soldadoCR06,2023,0.0152,0.2962,0.1557,154,10148,0,1,153,3,157,soldadoCR06,Avanzato,2193,2202,9,2
soldadoCR06,2024,0.0243,0.3,0.1622,247,10148,0,0,247,0,247,soldadoCR06,Avanzato,2184,2184,0,1
Tsala91,2023,0.4327,0.3027,0.3677,4391,10148,0,41,4350,1,4392,Tsala91,Intermedio,1830,1758,-72,3
Tsala91,2024,0.462,0.3038,0.3829,4688,10148,0,71,4617,11,4699,Tsala91,Intermedio,1758,1748,-10,2
Tsala91,2025,0.1674,0.3,0.2337,1699,10148,0,0,1699,0,1699,Tsala91,Intermedio,1748,1823,75,3
mmarcelops,2023,0.2697,0.2988,0.2843,2737,10148,0,1,2736,12,2749,mmarcelops,Beginner,1361,1356,-5,1
mmarcelops,2024,0.1684,0.3,0.2342,1709,10148,0,0,1709,0,1709,mmarcelops,Beginner,1356,1262,-94,8
mmarcelops,2025,0.2241,0.2995,0.2618,2274,10148,0,0,2274,4,2278,mmarcelops,Beginner,1273,1412,139,2
drakonsama,2023,0.1631,0.2989,0.231,1655,10148,0,0,1655,6,1661,drakonsama,Intermedio,1809,1806,-3,1
drakonsama,2024,0.0832,0.3011,0.1921,844,10148,0,3,841,0,844,drakonsama,Intermedio,1806,1785,-21,3
Zugfogel,2023,0.006,0.3,0.153,61,10148,0,0,61,0,61,Zugfogel,Avanzato,2112,2102,-10,1
Wildindian,2023,0.0777,0.3388,0.2082,788,10148,0,102,686,0,788,Wildindian,Master,2394,2420,26,4
Wildindian,2025,0.0986,0.3848,0.2417,1001,10148,0,283,718,0,1001,Wildindian,Master,2420,2407,-13,3
begphi,2023,0.0547,0.2679,0.1613,555,10148,0,13,542,81,636,begphi,Intermedio,1446,1410,-36,7
begphi,2024,0.3872,0.2915,0.3394,3929,10148,0,0,3929,114,4043,begphi,Intermedio,1410,1420,10,5
begphi,2025,0.0575,0.2817,0.1696,584,10148,0,0,584,38,622,begphi,Beginner,1368,1400,32,4
Tabarex,2023,0.2854,0.5104,0.3979,2896,10148,0,2060,836,17,2913,Tabarex,Avanzato,1965,1931,-34,3
Tabarex,2024,0.5776,0.4861,0.5318,5861,10148,0,3646,2215,6,5867,Tabarex,Avanzato,1931,2037,106,9
Tabarex,2025,0.1715,0.3221,0.2468,1740,10148,0,128,1612,0,1740,Tabarex,Avanzato,2037,2071,34,3
Olexiy_Bilych,2023,0.1104,0.4918,0.3011,1120,10148,0,716,404,0,1120,Olexiy_Bilych,Master,2401,2433,32,12
Olexiy_Bilych,2024,0.0813,0.5219,0.3016,825,10148,34,531,260,0,825,Olexiy_Bilych,Master,2433,2435,2,11
Olexiy_Bilych,2025,0.0275,0.4353,0.2314,279,10148,0,149,130,16,295,Olexiy_Bilych,Master,2435,2433,-2,7
Alexshirov,2023,0.0036,0.2235,0.1136,37,10148,0,1,36,14,51,Alexshirov,Avanzato,1955,1905,-50,2
Alexshirov,2024,0.0034,0.0318,0.0176,34,10148,0,0,34,287,321,Alexshirov,Avanzato,1905,1922,17,1
RR21,2023,0.1283,0.5343,0.3313,1302,10148,0,1017,285,0,1302,RR21,Intermedio,1786,1800,14,1
hugolve,2022,0.0001,0.6,0.3,1,10148,0,1,0,0,1,hugolve,Intermedio,1817,1747,-70,1
SmaraChess,2024,0.2505,0.3183,0.2844,2542,10148,0,206,2336,48,2590,SmaraChess,Avanzato,1942,1873,-69,2
M-Anwar,2023,0.2836,0.3306,0.3071,2878,10148,0,382,2496,80,2958,M-Anwar,Avanzato,2075,2046,-29,5
M-Anwar,2024,0.208,0.3506,0.2793,2111,10148,0,356,1755,0,2111,M-Anwar,Avanzato,2046,2047,1,7
M-Anwar,2025,0.1858,0.2986,0.2422,1885,10148,0,10,1875,19,1904,M-Anwar,Avanzato,2047,2029,-18,1
I_B_N,2024,0.5167,0.5891,0.5529,5243,10148,0,5052,191,0,5243,I_B_N,Avanzato,1908,1972,64,2
I_B_N,2025,0.4326,0.5946,0.5136,4390,10148,0,4311,79,0,4390,I_B_N,Avanzato,1972,1978,6,3
Ynot-60,2023,0.0007,0.0004,0.0005,7,10148,0,0,7,5140,5147,Ynot-60,Intermedio,1692,1701,9,7
Richi51,2023,0.2066,0.3708,0.2887,2097,10148,0,548,1549,43,2140,Richi51,Avanzato,1974,1991,17,3
Richi51,2024,0.2137,0.3579,0.2858,2169,10148,0,497,1672,66,2235,Richi51,Avanzato,1991,1983,-8,4
Richi51,2025,0.1138,0.3039,0.2088,1155,10148,0,19,1136,4,1159,Richi51,Avanzato,1983,1922,-61,3
jaquematico,2022,0.0001,0.3,0.15,1,10148,0,0,1,0,1,jaquematico,Intermedio,1899,1898,-1,1
jaquematico,2023,0.1691,0.2991,0.2341,1716,10148,0,0,1716,5,1721,jaquematico,Intermedio,1898,1866,-32,2
jaquematico,2024,0.2333,0.427,0.3302,2368,10148,0,1098,1270,67,2435,jaquematico,Intermedio,1866,1800,-66,2
jaquematico,2025,0.4332,0.4721,0.4526,4396,10148,0,2591,1805,44,4440,jaquematico,Intermedio,1800,1797,-3,2
Archaeopath,2025,0.4235,0.5993,0.5114,4298,10148,0,4296,2,4,4302,Archaeopath,Avanzato,2055,2033,-22,1
XavierBusig,2024,0.3129,0.3131,0.313,3175,10148,0,735,2440,571,3746,XavierBusig,Avanzato,1983,1852,-131,3
ALEX183492761,2023,0.5034,0.5878,0.5456,5109,10148,400,4098,611,66,5175,ALEX183492761,Avanzato,1948,1970,22,1
TILAON,2023,0.0049,0.3,0.1525,50,10148,0,0,50,0,50,TILAON,Intermedio,1509,1487,-22,1
TILAON,2024,0.033,0.376,0.2045,335,10148,0,140,195,44,379,TILAON,Intermedio,1487,1498,11,2
TILAON,2025,0.1282,0.405,0.2666,1301,10148,13,745,543,237,1538,TILAON,Intermedio,1498,1662,164,3
Necochea,2023,0.8027,0.5112,0.6569,8146,10148,545,4989,2612,309,8455,Necochea,Intermedio,1758,1698,-60,2
Necochea,2024,0.9239,0.5155,0.7197,9376,10148,544,5772,3060,178,9554,Necochea,Intermedio,1698,1690,-8,1
profaVa,2023,0.3804,0.2491,0.3148,3860,10148,0,265,3595,1107,4967,profaVa,Master,2281,2237,-44,1
profaVa,2024,0.233,0.1506,0.1918,2364,10148,0,9,2355,2364,4728,profaVa,Master,2237,2205,-32,1
GomezDavid,2023,0.1376,0.3234,0.2305,1396,10148,0,109,1287,0,1396,GomezDavid,Master,2312,2345,33,3
GomezDavid,2024,0.192,0.3071,0.2495,1948,10148,0,46,1902,0,1948,GomezDavid,Master,2345,2312,-33,4
GomezDavid,2025,0.1235,0.3005,0.212,1253,10148,0,2,1251,0,1253,GomezDavid,Master,2312,2406,94,4
Fabsonpalhano,2023,0.4629,0.3529,0.4079,4698,10148,0,828,3870,0,4698,Fabsonpalhano,Avanzato,1968,1951,-17,1
Fabsonpalhano,2024,0.3649,0.3316,0.3482,3703,10148,0,390,3313,0,3703,Fabsonpalhano,Avanzato,1951,1920,-31,1
Fabsonpalhano,2025,0.2403,0.3312,0.2858,2439,10148,0,254,2185,0,2439,Fabsonpalhano,Avanzato,1920,1890,-30,1
vrugu,2024,0.9849,0.6,0.7925,9995,10148,0,9995,0,0,9995,vrugu,Intermedio,1600,1587,-13,1
vrugu,2025,0.7705,0.6,0.6852,7819,10148,0,7819,0,0,7819,vrugu,Intermedio,1587,1503,-84,1
Kaizzer,2023,0.2538,0.5156,0.3847,2576,10148,0,1863,713,7,2583,Kaizzer,Master,2427,2402,-25,1
nomanzana,2023,0.244,0.2913,0.2676,2476,10148,0,25,2451,100,2576,nomanzana,Intermedio,1492,1438,-54,2
nomanzana,2025,0.0725,0.2784,0.1754,736,10148,0,36,700,96,832,nomanzana,Intermedio,1438,1472,34,1
Alexmarquez1975,2024,0.1899,0.3274,0.2586,1927,10148,0,188,1739,11,1938,Alexmarquez1975,Beginner,1362,1322,-40,1
ALE_CUNHA,2023,0.2345,0.2967,0.2656,2380,10148,6,96,2278,138,2518,ALE_CUNHA,Intermedio,1831,1816,-15,1
m0528lm,2023,0.3413,0.4457,0.3935,3464,10148,1,1708,1755,19,3483,m0528lm,Intermedio,1869,1833,-36,2
m0528lm,2024,0.2594,0.2989,0.2791,2632,10148,0,5,2627,15,2647,m0528lm,Intermedio,1833,1803,-30,1
Hopik777,2023,0.2592,0.5877,0.4234,2630,10148,0,2542,88,10,2640,Hopik777,Intermedio,1501,1451,-50,3
Hopik777,2024,0.1431,0.5973,0.3702,1452,10148,0,1443,9,2,1454,Hopik777,Intermedio,1451,1438,-13,1
BrunoMoniz,2022,0.0001,0.6,0.3,1,10148,0,1,0,0,1,BrunoMoniz,Intermedio,1557,1537,-20,6
BrunoMoniz,2023,0.1832,0.5941,0.3886,1859,10148,0,1854,5,16,1875,BrunoMoniz,Intermedio,1537,1483,-54,7
BrunoMoniz,2024,0.1633,0.5987,0.381,1657,10148,0,1656,1,3,1660,BrunoMoniz,Intermedio,1483,1455,-28,5
BrunoMoniz,2025,0.0682,0.5991,0.3337,692,10148,0,692,0,1,693,BrunoMoniz,Intermedio,1455,1417,-38,4
latinsoviet,2023,0.1251,0.2963,0.2107,1270,10148,0,0,1270,16,1286,latinsoviet,Intermedio,1449,1438,-11,1
latinsoviet,2024,0.3474,0.3021,0.3247,3525,10148,0,55,3470,30,3555,latinsoviet,Intermedio,1438,1450,12,3
latinsoviet,2025,0.1891,0.523,0.3561,1919,10148,0,1444,475,10,1929,latinsoviet,Beginner,1387,1387,0,2
Dosaman77,2023,0.3796,0.2996,0.3396,3852,10148,0,1,3851,6,3858,Dosaman77,Avanzato,2131,1940,-191,1
chessenthil,2023,0.4805,0.3,0.3902,4876,10148,0,0,4876,0,4876,chessenthil,Intermedio,1402,1481,79,1
chessenthil,2024,0.4744,0.2999,0.3872,4814,10148,0,0,4814,1,4815,chessenthil,Intermedio,1481,1458,-23,4
chessenthil,2025,0.3438,0.2999,0.3219,3489,10148,0,0,3489,1,3490,chessenthil,Intermedio,1458,1432,-26,1
Franloa,2023,0.3707,0.3006,0.3357,3762,10148,0,10,3752,2,3764,Franloa,Intermedio,1812,1794,-18,3
Franloa,2024,0.4494,0.2997,0.3746,4561,10148,0,1,4560,5,4566,Franloa,Intermedio,1794,1800,6,4
Franloa,2025,0.239,0.2988,0.2689,2425,10148,0,2,2423,12,2437,Franloa,Intermedio,1800,1757,-43,5
KevinPaveto,2023,0.1865,0.5439,0.3652,1893,10148,24,1483,386,0,1893,KevinPaveto,Master,2439,2407,-32,5
KevinPaveto,2024,0.3801,0.555,0.4676,3857,10148,0,3279,578,0,3857,KevinPaveto,Master,2407,2406,-1,3
KevinPaveto,2025,0.2995,0.5959,0.4477,3039,10148,0,2997,42,0,3039,KevinPaveto,Master,2406,2415,9,3
klfo,2023,0.6743,0.5029,0.5886,6843,10148,26,4624,2193,34,6877,klfo,Avanzato,2031,2051,20,8
klfo,2024,0.4604,0.3919,0.4261,4672,10148,3,1447,3222,18,4690,klfo,Avanzato,2051,2039,-12,7
klfo,2025,0.2801,0.3757,0.3279,2842,10148,0,720,2122,2,2844,klfo,Avanzato,2039,2063,24,5
sonson28291,2023,0.5075,0.5874,0.5474,5150,10148,0,4953,197,10,5160,sonson28291,Beginner,1322,1439,117,4
sonson28291,2024,0.4492,0.4942,0.4717,4558,10148,0,2962,1596,7,4565,sonson28291,Intermedio,1439,1483,44,2
michelyglesias,2025,0.2466,0.2996,0.2731,2503,10148,0,0,2503,3,2506,michelyglesias,Avanzato,2100,2054,-46,1
CaxaRLian,2023,0.3339,0.4312,0.3825,3388,10148,0,1493,1895,8,3396,CaxaRLian,Avanzato,2056,2014,-42,6
CaxaRLian,2024,0.3514,0.3983,0.3749,3566,10148,14,1136,2416,0,3566,CaxaRLian,Avanzato,2014,2035,21,4
CaxaRLian,2025,0.124,0.3379,0.2309,1258,10148,0,159,1099,0,1258,CaxaRLian,Avanzato,2035,2078,43,5
GiovaniFla,2024,0.3934,0.3061,0.3497,3992,10148,0,2227,1765,2103,6095,GiovaniFla,Beginner,1347,1387,40,1
GiovaniFla,2025,0.4824,0.4256,0.454,4895,10148,0,3153,1742,778,5673,GiovaniFla,Beginner,1387,1400,13,1
ChrisDanger,2023,0.0144,0.4298,0.2221,146,10148,6,95,45,32,178,ChrisDanger,Beginner,1048,0,-1048,2
ChrisDanger,2024,0.0004,0.0293,0.0148,4,10148,0,0,4,37,41,ChrisDanger,Beginner,0,1175,1175,6
ChrisDanger,2025,0.0649,0.591,0.3279,659,10148,6,633,20,4,663,ChrisDanger,Beginner,1175,1278,103,3
Bravo3210,2023,0.2853,0.5493,0.4173,2895,10148,61,2269,565,3,2898,Bravo3210,Beginner,1395,1407,12,1
Bravo3210,2024,0.4124,0.5376,0.475,4185,10148,0,3329,856,8,4193,Bravo3210,Beginner,1333,1333,0,2
Bravo3210,2025,0.4241,0.5187,0.4714,4304,10148,5,3150,1149,14,4318,Bravo3210,Beginner,1303,1468,165,4
Chessian,2023,0.4276,0.3111,0.3693,4339,10148,0,181,4158,20,4359,Chessian,Intermedio,1605,1560,-45,9
Chessian,2024,0.4632,0.3309,0.3971,4701,10148,0,493,4208,8,4709,Chessian,Intermedio,1560,1633,73,7
Chessian,2025,0.3225,0.3105,0.3165,3273,10148,0,115,3158,0,3273,Chessian,Intermedio,1633,1553,-80,6
hasankose1983,2023,0.2122,0.2981,0.2551,2153,10148,0,0,2153,14,2167,hasankose1983,Intermedio,1465,1435,-30,3
hasankose1983,2024,0.2411,0.3001,0.2706,2447,10148,0,1,2446,0,2447,hasankose1983,Intermedio,1435,1428,-7,1
hasankose1983,2025,0.1263,0.3002,0.2133,1282,10148,0,1,1281,0,1282,hasankose1983,Intermedio,1428,1357,-71,2
Gnejak,2023,0.3358,0.3,0.3179,3408,10148,0,0,3408,0,3408,Gnejak,Avanzato,2083,2113,30,6
Gnejak,2024,0.3322,0.3,0.3161,3371,10148,0,0,3371,0,3371,Gnejak,Avanzato,2113,2188,75,8
Gnejak,2025,0.1864,0.3,0.2432,1892,10148,0,0,1892,0,1892,Gnejak,Avanzato,2193,2156,-37,4
Pogi13,2024,0.0945,0.559,0.3268,959,10148,0,828,131,0,959,Pogi13,Avanzato,1900,1833,-67,1
DanteLoguzzo,2023,0.303,0.5595,0.4313,3075,10148,30,2601,444,6,3081,DanteLoguzzo,Intermedio,1742,1726,-16,1
girish1106,2022,0.0001,0.3,0.15,1,10148,0,0,1,0,1,girish1106,Intermedio,1670,1656,-14,1
Dusankostic,2023,0.3707,0.5461,0.4584,3762,10148,19,3045,698,2,3764,Dusankostic,Intermedio,1464,1499,35,1
Dusankostic,2024,0.537,0.5955,0.5662,5449,10148,0,5376,73,4,5453,Dusankostic,Intermedio,1499,1603,104,3
Dusankostic,2025,0.46,0.5995,0.5297,4668,10148,0,4664,4,2,4670,Dusankostic,Intermedio,1603,1690,87,2
Slovafn,2023,0.0222,0.2015,0.1118,225,10148,0,0,225,110,335,Slovafn,Avanzato,2173,2177,4,3
Slovafn,2024,0.0371,0.3495,0.1933,376,10148,0,154,222,79,455,Slovafn,Avanzato,2177,2093,-84,3
Slovafn,2025,0.1074,0.2811,0.1942,1090,10148,0,9,1081,83,1173,Slovafn,Avanzato,2093,2124,31,4
CamiloZaur,2023,0.0418,0.3775,0.2097,424,10148,0,248,176,110,534,CamiloZaur,Beginner,1122,1222,100,3
CamiloZaur,2024,0.0829,0.4229,0.2529,841,10148,0,398,443,38,879,CamiloZaur,Beginner,1222,1083,-139,4
CamiloZaur,2025,0.1581,0.3308,0.2444,1604,10148,0,170,1434,5,1609,CamiloZaur,Beginner,1083,1080,-3,1
JoseUncal,2024,0.1915,0.3162,0.2538,1943,10148,0,145,1798,38,1981,JoseUncal,Intermedio,1894,1838,-56,1
Olajoinie1964,2023,0.0346,0.3,0.1673,351,10148,0,0,351,0,351,Olajoinie1964,Intermedio,1601,1580,-21,4
Olajoinie1964,2024,0.1677,0.3,0.2339,1702,10148,0,0,1702,0,1702,Olajoinie1964,Intermedio,1580,1590,10,1
Olajoinie1964,2025,0.0937,0.3,0.1969,951,10148,0,0,951,0,951,Olajoinie1964,Intermedio,1590,1620,30,4
boransavran,2025,0.0495,0.1413,0.0954,502,10148,0,196,306,980,1482,boransavran,Intermedio,1582,1867,285,3
cabronauta,2024,0.144,0.2992,0.2216,1461,10148,0,1,1460,5,1466,cabronauta,Intermedio,1883,1895,12,1
mallack01,2023,0.1635,0.2366,0.2,1659,10148,2,472,1185,1049,2708,mallack01,Beginner,1318,1356,38,1
chessbag,2023,0.103,0.438,0.2705,1045,10148,0,494,551,9,1054,chessbag,Intermedio,1469,1489,20,2
chessbag,2024,0.18,0.3531,0.2666,1827,10148,0,381,1446,49,1876,chessbag,Intermedio,1489,1520,31,3
chessbag,2025,0.3076,0.3992,0.3534,3122,10148,0,1121,2001,67,3189,chessbag,Intermedio,1520,1643,123,5
Superdioni,2023,0.2409,0.5973,0.4191,2445,10148,0,2423,22,0,2445,Superdioni,Avanzato,1982,1992,10,3
Superdioni,2024,0.2277,0.5997,0.4137,2311,10148,0,2309,2,0,2311,Superdioni,Avanzato,1992,1972,-20,6
monlevade,2023,0.0951,0.2844,0.1897,965,10148,0,0,965,53,1018,monlevade,Intermedio,1715,1721,6,1
Sergio-czabanyi,2023,0.1997,0.3,0.2499,2027,10148,0,1,2026,1,2028,Sergio-czabanyi,Intermedio,1407,1419,12,3
Sergio-czabanyi,2024,0.2319,0.3008,0.2663,2353,10148,0,8,2345,2,2355,Sergio-czabanyi,Intermedio,1419,1440,21,2
Sergio-czabanyi,2025,0.1321,0.3,0.2161,1341,10148,0,0,1341,0,1341,Sergio-czabanyi,Intermedio,1440,1405,-35,1
TTwwTT,2024,0.5724,0.3001,0.4362,5809,10148,0,1,5808,0,5809,TTwwTT,Intermedio,1791,1778,-13,2
TTwwTT,2025,0.374,0.3,0.337,3795,10148,0,0,3795,0,3795,TTwwTT,Intermedio,1778,1773,-5,3
Alx_Boorges,2024,0.1531,0.3,0.2266,1554,10148,0,0,1554,0,1554,Alx_Boorges,Beginner,1223,1198,-25,1
Skyline83,2024,0.1197,0.5995,0.3596,1215,10148,0,1213,2,0,1215,Skyline83,Beginner,1258,1255,-3,1
nonsopolo,2023,0.3531,0.3846,0.3688,3583,10148,0,1010,2573,0,3583,nonsopolo,Avanzato,2195,2181,-14,4
nonsopolo,2024,0.4261,0.5334,0.4798,4324,10148,0,3386,938,12,4336,nonsopolo,Avanzato,2131,2088,-43,3
nonsopolo,2025,0.2452,0.5725,0.4088,2488,10148,0,2260,228,0,2488,nonsopolo,Avanzato,2088,2087,-1,2
Amaya_Carlo_9999,2024,0.3179,0.2808,0.2993,3226,10148,0,2,3224,223,3449,Amaya_Carlo_9999,Beginner,1237,1203,-34,1
Gertvb,2023,0.1124,0.3089,0.2107,1141,10148,0,34,1107,0,1141,Gertvb,Intermedio,1856,1779,-77,8
Gertvb,2024,0.1254,0.3594,0.2424,1273,10148,0,252,1021,0,1273,Gertvb,Intermedio,1779,1773,-6,6
Gertvb,2025,0.0697,0.3624,0.216,707,10148,0,147,560,0,707,Gertvb,Intermedio,1773,1750,-23,6
grepabole23,2023,0.301,0.4785,0.3898,3055,10148,0,1928,1127,69,3124,grepabole23,Intermedio,1854,1805,-49,2
jansiebold,2023,0.0031,0.0026,0.0028,31,10148,0,2,29,3735,3766,jansiebold,Intermedio,1601,1693,92,3
jansiebold,2024,0.0044,0.0044,0.0044,45,10148,1,2,42,3310,3355,jansiebold,Intermedio,1693,1720,27,2
jansiebold,2025,0.0051,0.0056,0.0054,52,10148,1,1,50,2896,2948,jansiebold,Intermedio,1720,1775,55,2
Silverpearl,2023,0.8441,0.5996,0.7219,8566,10148,0,8555,11,0,8566,Silverpearl,Avanzato,2024,2021,-3,3
Silverpearl,2024,0.6919,0.5975,0.6447,7021,10148,0,6962,59,0,7021,Silverpearl,Avanzato,2021,1915,-106,5
Silverpearl,2025,0.3613,0.5975,0.4794,3666,10148,0,3636,30,0,3666,Silverpearl,Avanzato,1915,1982,67,3
Bullet_House,2023,0.3422,0.5375,0.4399,3473,10148,0,2807,666,32,3505,Bullet_House,Intermedio,1785,1812,27,6
Bullet_House,2024,0.4732,0.5533,0.5132,4802,10148,0,4119,683,35,4837,Bullet_House,Intermedio,1812,1800,-12,5
Slanoushien,2023,0.185,0.3152,0.2501,1877,10148,0,97,1780,2,1879,Slanoushien,Intermedio,1671,1655,-16,1
REDKLION,2023,0.6224,0.3,0.4612,6316,10148,0,0,6316,0,6316,REDKLION,Intermedio,1873,1827,-46,3
REDKLION,2024,0.9851,0.3,0.6426,9997,10148,0,0,9997,0,9997,REDKLION,Intermedio,1827,1810,-17,3
REDKLION,2025,0.4875,0.3,0.3937,4947,10148,0,0,4947,0,4947,REDKLION,Intermedio,1810,1757,-53,4
Phillycheesesteak3,2024,0.1602,0.4356,0.2979,1626,10148,0,777,849,29,1655,Phillycheesesteak3,Intermedio,1527,1537,10,2
Phillycheesesteak3,2025,0.0068,0.3,0.1534,69,10148,0,0,69,0,69,Phillycheesesteak3,Intermedio,1537,1492,-45,1
RubenIguazu1982,2024,0.2909,0.2943,0.2926,2952,10148,1,0,2951,60,3012,RubenIguazu1982,Beginner,1311,1338,27,1
Erwin_Calar,2023,0.9791,0.5929,0.786,9936,10148,12,9778,146,54,9990,Erwin_Calar,Beginner,1349,1403,54,2
Erwin_Calar,2024,0.9785,0.5928,0.7857,9930,10148,0,9692,238,0,9930,Erwin_Calar,Beginner,1362,1402,40,2
Dominov,2023,0.0153,0.4994,0.2573,155,10148,0,103,52,0,155,Dominov,Avanzato,2040,2040,0,3
Dominov,2024,0.6507,0.5913,0.621,6603,10148,0,6413,190,1,6604,Dominov,Avanzato,2040,2046,6,2
Dominov,2025,0.2442,0.5992,0.4217,2478,10148,0,2471,7,0,2478,Dominov,Avanzato,2046,2032,-14,2
sylvesters,2024,0.5885,0.4146,0.5015,5972,10148,0,2281,3691,0,5972,sylvesters,Avanzato,1929,1940,11,1
sylvesters,2025,0.9843,0.5532,0.7688,9989,10148,0,8433,1556,1,9990,sylvesters,Avanzato,1940,1937,-3,2
Disord,2023,0.3063,0.2959,0.3011,3108,10148,0,103,3005,148,3256,Disord,Intermedio,1869,1885,16,1
DonBello,2023,0.0667,0.2887,0.1777,677,10148,0,88,589,118,795,DonBello,Intermedio,1793,1690,-103,2
Alelanlo,2023,0.2062,0.3891,0.2977,2093,10148,0,854,1239,179,2272,Alelanlo,Beginner,1147,1139,-8,1
Alelanlo,2024,0.0793,0.3453,0.2123,805,10148,0,224,581,89,894,Alelanlo,Beginner,1139,1138,-1,1
iat00,2025,0.2631,0.3,0.2816,2670,10148,0,0,2670,0,2670,iat00,Avanzato,2005,2056,51,1
DerGaertner2014,2023,0.1639,0.5343,0.3491,1663,10148,0,1299,364,0,1663,DerGaertner2014,Avanzato,2124,2135,11,2
DerGaertner2014,2024,0.2575,0.5527,0.4051,2613,10148,0,2201,412,0,2613,DerGaertner2014,Avanzato,2135,2169,34,8
DerGaertner2014,2025,0.2248,0.5895,0.4071,2281,10148,0,2201,80,0,2281,DerGaertner2014,Avanzato,2169,2134,-35,1
omoueza,2023,0.0007,0.0025,0.0016,7,10148,0,0,7,826,833,omoueza,Intermedio,1644,1602,-42,1
omoueza,2024,0.0001,0.0004,0.0002,1,10148,0,0,1,841,842,omoueza,Intermedio,1602,1587,-15,1
Jonathan03,2023,0.5902,0.3192,0.4547,5989,10148,30,632,5327,300,6289,Jonathan03,Intermedio,1781,1564,-217,5
Jonathan03,2024,0.2983,0.3113,0.3048,3027,10148,0,360,2667,237,3264,Jonathan03,Intermedio,1564,1553,-11,8
paupin,2023,0.4456,0.3,0.3728,4522,10148,0,0,4522,0,4522,paupin,Avanzato,2131,2171,40,10
paupin,2024,0.3813,0.3,0.3406,3869,10148,0,0,3869,0,3869,paupin,Avanzato,2171,2093,-78,7
paupin,2025,0.4369,0.3001,0.3685,4434,10148,0,2,4432,0,4434,paupin,Avanzato,2093,2076,-17,6
TerimakiQuando,2023,0.1566,0.3435,0.25,1589,10148,7,223,1359,8,1597,TerimakiQuando,Intermedio,1571,1613,42,2
TerimakiQuando,2024,0.1884,0.3624,0.2754,1912,10148,12,377,1523,6,1918,TerimakiQuando,Intermedio,1613,1622,9,3
alexzandrosrojo,2023,0.169,0.3327,0.2509,1715,10148,0,187,1528,0,1715,alexzandrosrojo,Intermedio,1682,1734,52,2
alexzandrosrojo,2024,0.2067,0.336,0.2714,2098,10148,0,252,1846,0,2098,alexzandrosrojo,Intermedio,1734,1720,-14,1
PabloSandoval2174,2023,0.2979,0.5372,0.4176,3023,10148,18,2395,610,26,3049,PabloSandoval2174,Intermedio,1758,1729,-29,2
Shan100,2023,0.7282,0.2219,0.4751,7390,10148,0,0,7390,2600,9990,Shan100,Intermedio,1787,1776,-11,3
GerhardG,2023,0.5224,0.3,0.4112,5301,10148,0,0,5301,0,5301,GerhardG,Avanzato,1956,1967,11,1
GerhardG,2024,0.4934,0.3002,0.3968,5007,10148,0,3,5004,0,5007,GerhardG,Avanzato,1967,1917,-50,1
GerhardG,2025,0.3091,0.2994,0.3043,3137,10148,0,0,3137,6,3143,GerhardG,Avanzato,1917,1863,-54,1
Attirov,2023,0.9559,0.5765,0.7662,9700,10148,0,9005,695,34,9734,Attirov,Intermedio,1627,1518,-109,2
Attirov,2024,0.4653,0.5922,0.5288,4722,10148,0,4621,101,11,4733,Attirov,Intermedio,1518,1503,-15,1
Lxevenxl,2024,0.8546,0.5832,0.7189,8672,10148,19,8149,504,4,8676,Lxevenxl,Avanzato,1908,1908,0,1
Lxevenxl,2025,0.396,0.5657,0.4809,4019,10148,104,3317,598,0,4019,Lxevenxl,Avanzato,1908,1923,15,1
ricord,2024,0.002,0.017,0.0095,20,10148,0,0,20,332,352,ricord,Intermedio,1530,1527,-3,1
ricord,2025,0.003,0.0353,0.0191,30,10148,0,0,30,225,255,ricord,Intermedio,1527,1528,1,1
ErickGac,2024,0.1559,0.4449,0.3004,1582,10148,0,874,708,74,1656,ErickGac,Avanzato,1933,1900,-33,2
ErickGac,2025,0.1025,0.4745,0.2885,1040,10148,0,605,435,0,1040,ErickGac,Avanzato,1900,1900,0,2
Camps96,2023,0.1941,0.3776,0.2859,1970,10148,0,521,1449,9,1979,Camps96,Avanzato,2158,2170,12,2
Camps96,2024,0.2666,0.5942,0.4304,2705,10148,0,2659,46,3,2708,Camps96,Avanzato,2170,2145,-25,1
Mark-Bueno,2023,0.1997,0.3,0.2499,2027,10148,0,1,2026,1,2028,Mark-Bueno,Avanzato,2048,2049,1,5
Mark-Bueno,2024,0.1743,0.3047,0.2395,1769,10148,0,28,1741,0,1769,Mark-Bueno,Avanzato,2049,2051,2,6
Mark-Bueno,2025,0.1178,0.3126,0.2152,1195,10148,0,50,1145,0,1195,Mark-Bueno,Avanzato,2051,2043,-8,5
DrArdilla,2023,0.5199,0.599,0.5595,5276,10148,0,5263,13,2,5278,DrArdilla,Intermedio,1757,1769,12,3
DrArdilla,2024,0.5948,0.5998,0.5973,6036,10148,0,6033,3,1,6037,DrArdilla,Intermedio,1769,1760,-9,1
DrArdilla,2025,0.8414,0.5999,0.7207,8539,10148,0,8539,0,1,8540,DrArdilla,Intermedio,1760,1740,-20,4
LUCASSILVA2686,2023,0.1662,0.534,0.3501,1687,10148,0,1316,371,0,1687,LUCASSILVA2686,Master,2241,2283,42,4
LUCASSILVA2686,2024,0.1666,0.5718,0.3692,1691,10148,0,1532,159,0,1691,LUCASSILVA2686,Master,2283,2246,-37,6
LUCASSILVA2686,2025,0.0587,0.453,0.2559,596,10148,0,304,292,0,596,LUCASSILVA2686,Master,2246,2214,-32,6
ELIASCAPO,2023,0.1012,0.2395,0.1704,1027,10148,0,38,989,307,1334,ELIASCAPO,Beginner,1165,1147,-18,5
ELIASCAPO,2024,0.1392,0.3101,0.2247,1413,10148,2,81,1330,37,1450,ELIASCAPO,Beginner,1147,1245,98,5
ELIASCAPO,2025,0.1345,0.3037,0.2191,1365,10148,0,29,1336,12,1377,ELIASCAPO,Beginner,1245,1297,52,2
Diego28Brazil,2025,0.1304,0.4984,0.3144,1323,10148,0,1028,295,92,1415,Diego28Brazil,Intermedio,1890,1847,-43,1
blackstar2u,2023,0.5328,0.3209,0.4268,5407,10148,0,404,5003,26,5433,blackstar2u,Intermedio,1753,1681,-72,1
blackstar2u,2024,0.4844,0.3256,0.405,4916,10148,0,420,4496,0,4916,blackstar2u,Intermedio,1681,1675,-6,2
blackstar2u,2025,0.2074,0.3289,0.2682,2105,10148,0,216,1889,12,2117,blackstar2u,Intermedio,1675,1827,152,4
The-Gov,2023,0.111,0.1316,0.1213,1126,10148,0,0,1126,1440,2566,The-Gov,Intermedio,1700,1686,-14,2
The-Gov,2024,0.0013,0.0033,0.0023,13,10148,0,11,2,2176,2189,The-Gov,Intermedio,1686,1613,-73,3
The-Gov,2025,0.0829,0.1577,0.1203,841,10148,0,0,841,759,1600,The-Gov,Intermedio,1613,1612,-1,2
deepersystems,2023,0.7352,0.5977,0.6665,7461,10148,0,7404,57,0,7461,deepersystems,Avanzato,2005,1930,-75,2
deepersystems,2024,0.7652,0.5998,0.6825,7765,10148,0,7761,4,0,7765,deepersystems,Avanzato,1930,1852,-78,2
deepersystems,2025,0.466,0.6,0.533,4729,10148,0,4729,0,0,4729,deepersystems,Avanzato,1905,1905,0,2
Dampchess,2023,0.0036,0.3,0.1518,37,10148,0,0,37,0,37,Dampchess,Master,2369,2342,-27,3
Dampchess,2024,0.0625,0.5896,0.326,634,10148,0,612,22,0,634,Dampchess,Master,2342,2320,-22,4
LaraCroft_1,2023,0.3543,0.6134,0.4838,3595,10148,622,2318,655,7,3602,LaraCroft_1,Intermedio,1757,1756,-1,1
LaraCroft_1,2024,0.146,0.5982,0.3721,1482,10148,9,1452,21,0,1482,LaraCroft_1,Intermedio,1756,1767,11,1
ingjeo,2025,0.3102,0.5975,0.4539,3148,10148,0,3122,26,0,3148,ingjeo,Intermedio,1620,1680,60,1
dens17,2025,0.3288,0.4163,0.3726,3337,10148,0,1303,2034,7,3344,dens17,Beginner,1377,1398,21,1
assad,2023,0.1556,0.5165,0.3361,1579,10148,0,1193,386,31,1610,assad,Intermedio,1758,1736,-22,1
SebachesS777,2023,0.4298,0.2958,0.3628,4362,10148,0,85,4277,148,4510,SebachesS777,Avanzato,1998,1975,-23,2
SebachesS777,2024,0.4779,0.2981,0.388,4850,10148,0,0,4850,31,4881,SebachesS777,Avanzato,1975,1878,-97,2
masmago2,2024,0.4332,0.4687,0.4509,4396,10148,0,2519,1877,30,4426,masmago2,Intermedio,1589,1460,-129,4
masmago2,2025,0.2088,0.4617,0.3353,2119,10148,0,1213,906,46,2165,masmago2,Intermedio,1460,1463,3,1
Joski67,2023,0.273,0.3002,0.2866,2770,10148,0,2,2768,0,2770,Joski67,Avanzato,2065,2034,-31,1
Joski67,2024,0.3262,0.3001,0.3131,3310,10148,0,3,3307,2,3312,Joski67,Avanzato,2034,1932,-102,6
Joski67,2025,0.2499,0.3,0.275,2536,10148,0,1,2535,1,2537,Joski67,Avanzato,1932,1910,-22,4
Aime23,2023,0.0607,0.5723,0.3165,616,10148,0,561,55,1,617,Aime23,Beginner,1352,1413,61,3
Aime23,2024,0.1702,0.5876,0.3789,1727,10148,0,1673,54,9,1736,Aime23,Beginner,1380,1468,88,4
Aime23,2025,0.1851,0.4952,0.3401,1878,10148,0,1235,643,8,1886,Aime23,Intermedio,1468,1493,25,2
denisgov,2025,0.1744,0.5497,0.3621,1770,10148,1,1471,298,0,1770,denisgov,Avanzato,1930,1833,-97,1
BUZO66,2022,0.0001,0.3,0.15,1,10148,0,0,1,0,1,BUZO66,Intermedio,1535,1510,-25,1
sinuylehcimsinuy,2023,0.4648,0.5994,0.5321,4717,10148,0,4707,10,0,4717,sinuylehcimsinuy,Avanzato,2196,2219,23,2
sinuylehcimsinuy,2024,0.9881,0.5999,0.794,10027,10148,0,10025,2,0,10027,sinuylehcimsinuy,Master,2219,2230,11,3
MigueShark,2024,0.2259,0.5041,0.365,2292,10148,0,1559,733,0,2292,MigueShark,Intermedio,1839,1808,-31,1
snorre990,2023,0.618,0.5691,0.5936,6271,10148,0,5628,643,1,6272,snorre990,Avanzato,1910,1914,4,2
snorre990,2024,0.3603,0.5987,0.4795,3656,10148,0,3648,8,4,3660,snorre990,Avanzato,1914,1883,-31,2
chacarita1010,2023,0.0744,0.1753,0.1248,755,10148,0,285,470,1025,1780,chacarita1010,Intermedio,1425,1400,-25,1
chacarita1010,2025,0.0296,0.1869,0.1082,300,10148,0,80,220,310,610,chacarita1010,Intermedio,1400,1330,-70,1
ACarreroPUC,2023,0.1026,0.5233,0.3129,1041,10148,0,801,240,15,1056,ACarreroPUC,Intermedio,1604,1525,-79,2
ACarreroPUC,2024,0.1071,0.4872,0.2971,1087,10148,0,683,404,3,1090,ACarreroPUC,Intermedio,1525,1497,-28,1
Christianorozcopro,2023,0.2405,0.4818,0.3612,2441,10148,31,1418,992,7,2448,Christianorozcopro,Intermedio,1667,1677,10,1
altamov,2024,0.1046,0.5432,0.3239,1061,10148,0,860,201,0,1061,altamov,Avanzato,1971,1925,-46,1
BrunoDeVita,2023,0.0127,0.1484,0.0806,129,10148,0,14,115,160,289,BrunoDeVita,Beginner,1313,1348,35,3
BrunoDeVita,2024,0.0185,0.1956,0.1071,188,10148,0,93,95,243,431,BrunoDeVita,Beginner,1348,1212,-136,5
BrunoDeVita,2025,0.0068,0.0982,0.0525,69,10148,0,2,67,148,217,BrunoDeVita,Beginner,1212,1182,-30,2
Reginaldoacre,2023,0.2109,0.4513,0.3311,2140,10148,0,1159,981,53,2193,Reginaldoacre,Intermedio,1806,1807,1,1
Reginaldoacre,2024,0.3936,0.4634,0.4285,3994,10148,0,2189,1805,9,4003,Reginaldoacre,Intermedio,1807,1815,8,3
Reginaldoacre,2025,0.2909,0.4361,0.3635,2952,10148,0,1370,1582,21,2973,Reginaldoacre,Intermedio,1815,1790,-25,1
claudioa,2024,0.9757,0.5658,0.7707,9901,10148,0,8941,960,89,9990,claudioa,Avanzato,2087,2098,11,2
nxduc,2023,0.0019,0.4826,0.2422,19,10148,0,18,1,4,23,nxduc,Intermedio,1723,1860,137,7
nxduc,2024,0.1328,0.4685,0.3007,1348,10148,20,965,363,163,1511,nxduc,Intermedio,1860,1837,-23,2
adrianom1985,2024,0.1739,0.3225,0.2482,1765,10148,8,1353,404,1153,2918,adrianom1985,Intermedio,1720,1822,102,2
DavidMiladinoff,2024,0.0704,0.2834,0.1769,714,10148,0,18,696,61,775,DavidMiladinoff,Beginner,1287,1325,38,1
DavidMiladinoff,2025,0.0731,0.2954,0.1842,742,10148,1,0,741,14,756,DavidMiladinoff,Beginner,1325,1295,-30,1
groofke,2023,0.1844,0.2998,0.2421,1871,10148,0,0,1871,1,1872,groofke,Intermedio,1575,1535,-40,9
groofke,2024,0.1158,0.2997,0.2078,1175,10148,0,0,1175,1,1176,groofke,Intermedio,1535,1568,33,4
groofke,2025,0.1244,0.3,0.2122,1262,10148,0,0,1262,0,1262,groofke,Intermedio,1568,1588,20,2
irakliberadze,2023,0.2227,0.5899,0.4063,2260,10148,0,2239,21,28,2288,irakliberadze,Master,2497,2507,10,4
irakliberadze,2024,0.2868,0.5925,0.4396,2910,10148,0,2865,45,14,2924,irakliberadze,Master,2507,2498,-9,3
irakliberadze,2025,0.1902,0.581,0.3856,1930,10148,0,1839,91,16,1946,irakliberadze,Master,2498,2488,-10,1
MiguelTSalta,2023,0.0095,0.305,0.1572,96,10148,0,27,69,25,121,MiguelTSalta,Intermedio,1512,1574,62,1
MiguelTSalta,2024,0.0055,0.1355,0.0705,56,10148,0,0,56,68,124,MiguelTSalta,Intermedio,1574,1573,-1,1
tjdahsyat,2025,0.1301,0.3111,0.2206,1320,10148,0,76,1244,26,1346,tjdahsyat,Intermedio,1718,1700,-18,1
micfel,2023,0.4027,0.3001,0.3514,4087,10148,0,2,4085,0,4087,micfel,Avanzato,2195,2195,0,2
micfel,2024,0.5109,0.3003,0.4056,5185,10148,0,8,5177,2,5187,micfel,Avanzato,2195,2182,-13,3
martinroldan23,2022,0.0001,0.3,0.15,1,10148,0,0,1,0,1,martinroldan23,Intermedio,1622,1616,-6,1
Laureano2010,2023,0.0294,0.296,0.1627,298,10148,0,0,298,4,302,Laureano2010,Intermedio,1493,1554,61,1
CentauroRex,2025,0.008,0.0056,0.0068,81,10148,0,1,80,4328,4409,CentauroRex,Intermedio,1550,1640,90,1
rvilarn,2022,0.0001,0.3,0.15,1,10148,0,0,1,0,1,rvilarn,Intermedio,1544,1616,72,2
Lime_chess55,2024,0.2909,0.2755,0.2832,2952,10148,0,33,2919,299,3251,Lime_chess55,Intermedio,1810,1720,-90,1
lastevora,2023,0.1665,0.305,0.2358,1690,10148,0,28,1662,0,1690,lastevora,Intermedio,1583,1572,-11,1
lastevora,2025,0.1667,0.3253,0.246,1692,10148,8,124,1560,0,1692,lastevora,Intermedio,1572,1603,31,2
Holdys,2023,0.5913,0.5774,0.5844,6001,10148,7,5751,243,113,6114,Holdys,Intermedio,1802,1809,7,5
Holdys,2024,0.61,0.5869,0.5984,6190,10148,5,5988,197,41,6231,Holdys,Intermedio,1809,1807,-2,8
Holdys,2025,0.3173,0.576,0.4466,3220,10148,0,2970,250,4,3224,Holdys,Intermedio,1807,1855,48,4
ajedrezcosi,2024,0.3047,0.3474,0.3261,3092,10148,7,558,2527,74,3166,ajedrezcosi,Avanzato,2001,1933,-68,1
ajedrezcosi,2025,0.224,0.4259,0.3249,2273,10148,103,780,1390,47,2320,ajedrezcosi,Avanzato,1933,1947,14,1
Alfonso_Hernandez,2024,0.003,0.2475,0.1252,30,10148,0,3,27,10,40,Alfonso_Hernandez,Intermedio,1897,1843,-54,1
Alfonso_Hernandez,2025,0.0307,0.3,0.1654,312,10148,0,0,312,0,312,Alfonso_Hernandez,Intermedio,1843,1850,7,1
ehozjan,2023,0.3346,0.5742,0.4544,3396,10148,0,3217,179,59,3455,ehozjan,Intermedio,1899,1897,-2,1
ehozjan,2024,0.2649,0.5909,0.4279,2688,10148,0,2608,80,1,2689,ehozjan,Intermedio,1897,1883,-14,2
EVART,2023,0.1146,0.2987,0.2067,1163,10148,0,2,1161,7,1170,EVART,Beginner,1139,1121,-18,1
EVART,2024,0.095,0.2975,0.1963,964,10148,0,0,964,8,972,EVART,Beginner,1121,1082,-39,3
EVART,2025,0.0602,0.2985,0.1794,611,10148,0,0,611,3,614,EVART,Beginner,1082,1050,-32,2
SirFaSunnyBoy,2023,0.5029,0.5778,0.5403,5103,10148,0,4758,345,17,5120,SirFaSunnyBoy,Avanzato,2091,2092,1,2
SirFaSunnyBoy,2024,0.4649,0.5421,0.5035,4718,10148,0,3882,836,41,4759,SirFaSunnyBoy,Avanzato,2092,2126,34,2
Agent_Manamana,2023,0.1593,0.5486,0.354,1617,10148,0,1455,162,63,1680,Agent_Manamana,Avanzato,1949,1908,-41,4
Eslovenia_Patagonia,2023,0.2774,0.3001,0.2888,2815,10148,0,4,2811,3,2818,Eslovenia_Patagonia,Avanzato,2175,2162,-13,1
Eslovenia_Patagonia,2024,0.2674,0.3001,0.2838,2714,10148,0,1,2713,0,2714,Eslovenia_Patagonia,Avanzato,2162,2165,3,4
Eslovenia_Patagonia,2025,0.3624,0.3001,0.3313,3678,10148,0,1,3677,0,3678,Eslovenia_Patagonia,Avanzato,2165,2174,9,2
ilcapodelsur,2023,0.9844,0.555,0.7697,9990,10148,0,8493,1497,0,9990,ilcapodelsur,Intermedio,1866,1890,24,1
Jwjesq,2023,0.2681,0.4099,0.339,2721,10148,0,1121,1600,91,2812,Jwjesq,Intermedio,1479,1650,171,5
Jwjesq,2024,0.2805,0.3956,0.3381,2847,10148,0,1187,1660,212,3059,Jwjesq,Intermedio,1650,1568,-82,4
Jwjesq,2025,0.2164,0.4376,0.327,2196,10148,0,1146,1050,95,2291,Jwjesq,Intermedio,1568,1612,44,3
Toxicochess,2023,0.8976,0.4579,0.6777,9109,10148,0,5769,3340,639,9748,Toxicochess,Intermedio,1616,1604,-12,1
chule2,2024,0.6985,0.3047,0.5016,7088,10148,0,514,6574,396,7484,chule2,Intermedio,1760,1737,-23,1
Polonoobmaster25,2023,0.1655,0.3706,0.268,1679,10148,0,437,1242,34,1713,Polonoobmaster25,Beginner,1356,1356,0,1
Polonoobmaster25,2024,0.0608,0.4376,0.2492,617,10148,0,283,334,0,617,Polonoobmaster25,Beginner,1356,1357,1,1
Polonoobmaster25,2025,0.0879,0.3542,0.221,892,10148,0,167,725,5,897,Polonoobmaster25,Beginner,1357,1353,-4,1
omahajeff,2024,0.9842,0.4478,0.716,9988,10148,0,4923,5065,2,9990,omahajeff,Beginner,1358,1365,7,1
t_umegard,2024,0.1406,0.3919,0.2663,1427,10148,0,466,961,22,1449,t_umegard,Avanzato,2030,2061,31,1
t_umegard,2025,0.0991,0.4615,0.2803,1006,10148,0,557,449,10,1016,t_umegard,Avanzato,2061,2063,2,1
Nibblenobble,2023,0.1055,0.2908,0.1982,1071,10148,0,2,1069,36,1107,Nibblenobble,Intermedio,1813,1753,-60,1
Nibblenobble,2024,0.1198,0.2927,0.2063,1216,10148,2,0,1214,35,1251,Nibblenobble,Intermedio,1753,1732,-21,1
Michmich84,2023,0.2116,0.3511,0.2813,2147,10148,0,1610,537,1063,3210,Michmich84,Beginner,1291,1349,58,1
Michmich84,2024,0.2967,0.3282,0.3125,3011,10148,0,1436,1575,1054,4065,Michmich84,Beginner,1349,1175,-174,2
Korlyns,2025,0.277,0.4521,0.3645,2811,10148,24,1390,1397,14,2825,Korlyns,Intermedio,1585,1608,23,1
Turcusman,2024,0.1625,0.2081,0.1853,1649,10148,0,32,1617,774,2423,Turcusman,Beginner,1315,1278,-37,2
kishor1974,2024,0.4121,0.3026,0.3573,4182,10148,0,40,4142,4,4186,kishor1974,Beginner,1380,1380,0,2
kishor1974,2025,0.15,0.2847,0.2174,1522,10148,0,8,1514,90,1612,kishor1974,Beginner,1308,1285,-23,1
rvno12,2024,0.1301,0.2816,0.2059,1320,10148,0,15,1305,102,1422,rvno12,Intermedio,1467,1420,-47,1
rvno12,2025,0.0516,0.275,0.1633,524,10148,0,82,442,137,661,rvno12,Intermedio,1420,1635,215,4
tammas,2025,0.3384,0.3,0.3192,3434,10148,0,0,3434,0,3434,tammas,Beginner,1193,1132,-61,1
Pichichu,2023,0.0039,0.405,0.2045,40,10148,0,14,26,0,40,Pichichu,Avanzato,1945,1888,-57,1
El_Alan,2025,0.1883,0.522,0.3552,1911,10148,0,1524,387,63,1974,El_Alan,Intermedio,1402,1517,115,1
jwr670,2024,0.2107,0.5031,0.3569,2138,10148,45,1544,549,120,2258,jwr670,Beginner,1384,1413,29,3
jwr670,2025,0.0692,0.4553,0.2622,702,10148,1,449,252,58,760,jwr670,Intermedio,1413,1645,232,4
HanSchut,2023,0.1461,0.4433,0.2947,1483,10148,0,744,739,24,1507,HanSchut,Avanzato,2101,2091,-10,1
HanSchut,2024,0.136,0.5152,0.3256,1380,10148,0,997,383,4,1384,HanSchut,Avanzato,2091,2088,-3,3
HanSchut,2025,0.0945,0.4853,0.2899,959,10148,0,610,349,11,970,HanSchut,Avanzato,2088,2057,-31,1
Blixtanders,2023,0.8419,0.5033,0.6726,8544,10148,78,6055,2411,266,8810,Blixtanders,Intermedio,1815,1823,8,9
Blixtanders,2024,0.9564,0.5109,0.7337,9706,10148,76,7177,2453,311,10017,Blixtanders,Intermedio,1823,1760,-63,6
Blixtanders,2025,0.4318,0.4419,0.4368,4382,10148,29,2455,1898,306,4688,Blixtanders,Intermedio,1760,1742,-18,6
The_challenge_09,2024,0.136,0.5555,0.3457,1380,10148,0,1177,203,1,1381,The_challenge_09,Avanzato,1912,1860,-52,1
fonchy1xx,2023,0.0191,0.3446,0.1819,194,10148,0,30,164,1,195,fonchy1xx,Intermedio,1795,1839,44,1
fonchy1xx,2025,0.137,0.4796,0.3083,1390,10148,0,832,558,0,1390,fonchy1xx,Intermedio,1838,1770,-68,1
Gustragoo,2025,0.2543,0.5963,0.4253,2581,10148,0,2549,32,0,2581,Gustragoo,Intermedio,1647,1632,-15,3
Leolim1986,2023,0.4381,0.5739,0.506,4446,10148,0,4071,375,6,4452,Leolim1986,Beginner,1379,1387,8,4
Leolim1986,2024,0.2301,0.5558,0.3929,2335,10148,2,1986,347,0,2335,Leolim1986,Beginner,1387,1480,93,12
Leolim1986,2025,0.1457,0.5949,0.3703,1479,10148,0,1454,25,0,1479,Leolim1986,Beginner,1393,1453,60,6
KAJUMA10,2023,0.0296,0.2379,0.1337,300,10148,0,22,278,106,406,KAJUMA10,Intermedio,1700,1686,-14,1
KAJUMA10,2024,0.0264,0.2551,0.1407,268,10148,0,16,252,66,334,KAJUMA10,Intermedio,1686,1653,-33,2
KAJUMA10,2025,0.0439,0.31,0.1769,445,10148,0,21,424,6,451,KAJUMA10,Intermedio,1653,1570,-83,2
Mi1964,2023,0.3171,0.3013,0.3092,3218,10148,0,14,3204,0,3218,Mi1964,Intermedio,1579,1618,39,4
Mi1964,2024,0.2669,0.3001,0.2835,2709,10148,0,1,2708,0,2709,Mi1964,Intermedio,1618,1625,7,5
Mi1964,2025,0.1185,0.3,0.2093,1203,10148,0,0,1203,0,1203,Mi1964,Intermedio,1625,1635,10,4
GerMan1988,2023,0.0417,0.4639,0.2528,423,10148,0,262,161,20,443,GerMan1988,Intermedio,1549,1399,-150,6
GerMan1988,2024,0.0604,0.3356,0.198,613,10148,0,85,528,11,624,GerMan1988,Beginner,1399,1405,6,7
GerMan1988,2025,0.0849,0.3073,0.1961,862,10148,0,22,840,1,863,GerMan1988,Beginner,1382,1382,0,3
vikio,2023,0.0195,0.0859,0.0527,198,10148,0,3,195,504,702,vikio,Intermedio,1663,1640,-23,4
vikio,2024,0.0076,0.0263,0.0169,77,10148,0,3,74,836,913,vikio,Intermedio,1640,1622,-18,1
vikio,2025,0.0045,0.0228,0.0137,46,10148,0,0,46,560,606,vikio,Intermedio,1622,1580,-42,2
massinissachess,2023,0.1615,0.3384,0.25,1639,10148,0,229,1410,17,1656,massinissachess,Beginner,1158,1186,28,1
massinissachess,2024,0.1781,0.3005,0.2393,1807,10148,0,3,1804,0,1807,massinissachess,Beginner,1186,1125,-61,1
HombredeBlues,2023,0.294,0.4431,0.3686,2984,10148,0,1456,1528,22,3006,HombredeBlues,Intermedio,1857,1856,-1,1
ChessVibesYT,2025,0.0033,0.2063,0.1048,33,10148,0,0,33,15,48,ChessVibesYT,Avanzato,2037,2003,-34,2
pucefausto,2023,0.3064,0.2334,0.2699,3109,10148,1,4,3104,895,4004,pucefausto,Beginner,1038,0,-1038,3
CWS495,2023,0.0485,0.4183,0.2334,492,10148,0,194,298,0,492,CWS495,Intermedio,1727,1703,-24,3
CWS495,2024,0.2011,0.5608,0.3809,2041,10148,0,1774,267,0,2041,CWS495,Intermedio,1703,1622,-81,3
CWS495,2025,0.1392,0.5346,0.3369,1413,10148,0,1105,308,0,1413,CWS495,Intermedio,1622,1582,-40,1
Mayis1997,2024,0.9625,0.3052,0.6338,9767,10148,5,179,9583,22,9789,Mayis1997,Beginner,1141,1210,69,4
Mayis1997,2025,0.9775,0.3183,0.6479,9920,10148,4,671,9245,70,9990,Mayis1997,Beginner,1210,1190,-20,2
Mauriciochess,2023,0.4073,0.3823,0.3948,4133,10148,0,1135,2998,1,4134,Mauriciochess,Avanzato,1939,1922,-17,1
Mauriciochess,2024,0.3112,0.3023,0.3067,3158,10148,0,27,3131,3,3161,Mauriciochess,Avanzato,1922,1910,-12,3
Mauriciochess,2025,0.2561,0.3029,0.2795,2599,10148,0,28,2571,3,2602,Mauriciochess,Avanzato,1910,1973,63,1
Joaquinjimenez,2023,0.173,0.3002,0.2366,1756,10148,0,1,1755,0,1756,Joaquinjimenez,Avanzato,2195,2195,0,6
Joaquinjimenez,2024,0.27,0.3,0.285,2740,10148,0,0,2740,0,2740,Joaquinjimenez,Avanzato,2147,2179,32,5
Joaquinjimenez,2025,0.229,0.3005,0.2648,2324,10148,0,4,2320,0,2324,Joaquinjimenez,Avanzato,2179,2157,-22,3
FILIPN05,2023,0.0254,0.4132,0.2193,258,10148,40,15,203,8,266,FILIPN05,Avanzato,2181,2185,4,7
FILIPN05,2024,0.0236,0.4432,0.2334,239,10148,0,120,119,4,243,FILIPN05,Avanzato,2195,2163,-32,6
FILIPN05,2025,0.1241,0.5684,0.3463,1259,10148,0,1155,104,15,1274,FILIPN05,Avanzato,2163,2128,-35,5
Tech0021,2024,0.0001,0.3,0.15,1,10148,0,0,1,0,1,Tech0021,Beginner,1345,1135,-210,2
Tech0021,2025,0.05,0.3,0.175,507,10148,0,0,507,0,507,Tech0021,Beginner,1135,1387,252,5
evandrorsilva,2025,0.4719,0.3094,0.3907,4789,10148,0,150,4639,0,4789,evandrorsilva,Avanzato,2129,2111,-18,1
CheKarloz,2023,0.9835,0.478,0.7308,9981,10148,0,5936,4045,9,9990,CheKarloz,Avanzato,2013,1989,-24,2
CheKarloz,2024,0.9857,0.4519,0.7188,10003,10148,30,4998,4975,1,10004,CheKarloz,Avanzato,1989,1943,-46,3
CheKarloz,2025,0.9809,0.5658,0.7733,9954,10148,0,8834,1120,8,9962,CheKarloz,Avanzato,1943,1940,-3,2
Mike-Wouzauski,2023,0.0543,0.0673,0.0608,551,10148,0,33,518,2054,2605,Mike-Wouzauski,Intermedio,1788,1767,-21,2
RRiRRautentico,2023,0.9818,0.3078,0.6448,9963,10148,0,286,9677,27,9990,RRiRRautentico,Beginner,1374,1344,-30,1
RRiRRautentico,2024,0.9654,0.3116,0.6385,9797,10148,0,579,9218,193,9990,RRiRRautentico,Beginner,1344,1305,-39,3
hernanjorgefer,2023,0.0391,0.2941,0.1666,397,10148,0,0,397,8,405,hernanjorgefer,Intermedio,1674,1659,-15,1
hernanjorgefer,2025,0.5907,0.2999,0.4453,5994,10148,0,1,5993,3,5997,hernanjorgefer,Intermedio,1658,1628,-30,1
cubi93,2023,0.1923,0.3069,0.2496,1951,10148,0,56,1895,11,1962,cubi93,Avanzato,1911,1918,7,1
ghiriart,2023,0.0004,0.825,0.4127,4,10148,3,0,1,0,4,ghiriart,Avanzato,1901,1838,-63,3
ghiriart,2024,0.1509,0.3,0.2254,1531,10148,0,0,1531,0,1531,ghiriart,Intermedio,1838,1805,-33,2
ghiriart,2025,0.0903,0.3,0.1951,916,10148,0,0,916,0,916,ghiriart,Intermedio,1805,1792,-13,2
EspacioCreativo,2024,0.4674,0.3061,0.3868,4743,10148,0,206,4537,107,4850,EspacioCreativo,Avanzato,1935,1950,15,1
Denio256,2025,0.4715,0.5209,0.4962,4785,10148,0,3525,1260,1,4786,Denio256,Intermedio,1708,1748,40,1
porotodeejay,2023,0.3811,0.2805,0.3308,3867,10148,0,11,3856,280,4147,porotodeejay,Intermedio,1713,1649,-64,1
Jairo2995,2023,0.0254,0.3,0.1627,258,10148,0,0,258,0,258,Jairo2995,Intermedio,1662,1596,-66,2
SamuelMV,2023,0.552,0.5413,0.5467,5602,10148,0,4506,1096,0,5602,SamuelMV,Avanzato,2075,2067,-8,4
SamuelMV,2024,0.7071,0.5862,0.6466,7176,10148,0,6845,331,0,7176,SamuelMV,Avanzato,2067,2089,22,2
SamuelMV,2025,0.6296,0.5963,0.613,6389,10148,0,6315,74,2,6391,SamuelMV,Avanzato,2089,2074,-15,1
julian_d,2024,0.9851,0.6844,0.8348,9997,10148,2179,7728,90,1,9998,julian_d,Intermedio,1431,1415,-16,1
julian_d,2025,0.7257,0.6156,0.6706,7364,10148,411,6789,164,1,7365,julian_d,Beginner,1393,1393,0,2
ArDraug,2024,0.0329,0.2879,0.1604,334,10148,0,0,334,14,348,ArDraug,Beginner,1304,1278,-26,1
ArDraug,2025,0.0186,0.2984,0.1585,189,10148,0,2,187,3,192,ArDraug,Beginner,1278,1302,24,1
ismaelemiliofluxa,2023,0.1454,0.302,0.2237,1476,10148,0,10,1466,0,1476,ismaelemiliofluxa,Intermedio,1819,1811,-8,1
MasterOfPovery,2023,0.253,0.4122,0.3326,2567,10148,0,1166,1401,150,2717,MasterOfPovery,Intermedio,1725,1747,22,10
MasterOfPovery,2024,0.3546,0.3262,0.3404,3598,10148,0,476,3122,149,3747,MasterOfPovery,Intermedio,1747,1808,61,5
MasterOfPovery,2025,0.1267,0.3002,0.2135,1286,10148,0,11,1275,10,1296,MasterOfPovery,Intermedio,1808,1760,-48,3
SCRaMbLE,2023,0.4065,0.5787,0.4926,4125,10148,0,3840,285,4,4129,SCRaMbLE,Intermedio,1855,1884,29,1
SCRaMbLE,2024,0.4372,0.5714,0.5043,4437,10148,1,4020,416,4,4441,SCRaMbLE,Avanzato,1910,1910,0,3
SCRaMbLE,2025,0.2548,0.5919,0.4234,2586,10148,0,2518,68,1,2587,SCRaMbLE,Avanzato,1918,1932,14,1
khedira99,2023,0.108,0.689,0.3985,1096,10148,449,470,177,42,1138,khedira99,Avanzato,1954,1929,-25,2
khedira99,2024,0.3016,0.5669,0.4343,3061,10148,186,2329,546,21,3082,khedira99,Avanzato,1929,2017,88,4
khedira99,2025,0.0478,0.4726,0.2602,485,10148,0,279,206,0,485,khedira99,Avanzato,2017,2038,21,3
Devrar,2023,0.0004,0.45,0.2252,4,10148,0,2,2,0,4,Devrar,Intermedio,1542,1687,145,3
Devrar,2024,0.0139,0.5191,0.2665,141,10148,0,103,38,0,141,Devrar,Intermedio,1687,1877,190,5
Devrar,2025,0.0965,0.592,0.3443,979,10148,0,953,26,0,979,Devrar,Avanzato,1913,1910,-3,3
exscelsior,2023,0.7094,0.4108,0.5601,7199,10148,29,2632,4538,30,7229,exscelsior,Intermedio,1750,1755,5,5
exscelsior,2024,0.5818,0.4373,0.5096,5904,10148,0,2710,3194,5,5909,exscelsior,Intermedio,1755,1765,10,5
exscelsior,2025,0.5266,0.4496,0.4881,5344,10148,0,2683,2661,12,5356,exscelsior,Intermedio,1765,1800,35,3
Ste062,2024,0.1085,0.3119,0.2102,1101,10148,0,205,896,155,1256,Ste062,Beginner,1147,1525,378,10
Ste062,2025,0.1453,0.3805,0.2629,1474,10148,0,421,1053,20,1494,Ste062,Intermedio,1525,1507,-18,6
CharlieBro,2023,0.0914,0.612,0.3517,928,10148,75,790,63,0,928,CharlieBro,Avanzato,2154,2139,-15,4
CharlieBro,2024,0.1811,0.5874,0.3843,1838,10148,0,1761,77,0,1838,CharlieBro,Avanzato,2139,2124,-15,1
CharlieBro,2025,0.1667,0.556,0.3614,1692,10148,0,1444,248,0,1692,CharlieBro,Avanzato,2124,2140,16,1
Fpier21,2023,0.1858,0.3748,0.2803,1886,10148,0,470,1416,0,1886,Fpier21,Intermedio,1842,1874,32,6
Fpier21,2024,0.0571,0.3,0.1785,579,10148,0,0,579,0,579,Fpier21,Avanzato,1907,1907,0,4
Fpier21,2025,0.0529,0.3011,0.177,537,10148,0,2,535,0,537,Fpier21,Avanzato,1920,1990,70,4
Passthefence,2023,0.0014,0.2333,0.1174,14,10148,0,0,14,4,18,Passthefence,Intermedio,1664,1700,36,1
Passthefence,2024,0.0175,0.3067,0.1621,178,10148,0,4,174,0,178,Passthefence,Intermedio,1700,1783,83,1
